#########
#   #  ##
# # ## ##
# #    ##
     # ##
A###B####
